###############
#             #
##A#B#C#D#### #
1#########4 # #
   2  3     # #

